TTTTTTTTTMMMMMMMTTTTTTTT
TTTTTTTTMMMXMMMMMMTTTTTT
TTTTTTTMMMMMMMMMMMMTTTTT
TTTTTTMMMMMMMMMMMMMTTTTT
TTTTTTMMMMMMMMMXMMMTTTTT
TTTTTTTMMMMMMMMMMMMTTTTT
TTTTTTTTMMMMMMMMMTTTTTTT
TTTTTTTTTMMMMMMMTTTTTTTT
TTTTTTTTTMMMTMMMMTTTTTTT
TTTTTTTMMMMMTTTMMMTTTTTT
TTTTTTMMMXMTTTTTTMMTTTTT
TTTTTTMMMMTTTTTTTMMMTTTT
TTTTTMMMMMMMTTTTMMMMMTTT
TTTTTMMMMMMMMMMMMMXMTTTT
TTTTTMMMMMMMMMMMMMMMTTTT
TTTTTMMMMMMMXMMMMMMMTTTT
TTTTTTMMMMMMMMMMMMMMTTTT
TTTTTTTMMMMMMMMMMMMTTTTT
TTTTTTTTTMMMMMMMMMTTTTTT
TTTTTTTTTTMMMAMMTTTTTTTT

