TTTTTTTTTMMMMMMM TTTTTTTT
TTTTTTTTMMMXMMMMMMTTTTTT
TTTTTTTMMMMMMMMMMMMTTTTT
TTTTTTMMMMMMMMMMMMMTTTTT
TTTTTTMMM XMMXMMMMMTTTTT
TTTTTTTMMMMMMMMMMMMTTTTT
TTTTTTTTMMMMMMMMTTTTTTTT
TTTTTTTTTTTMMMMTTTTTTTTT
TTTTTTTTTM  NMMTTTTTTTTT
TTTTTTTMMMMMMMMMMMMTTTTTT
TTTTTTMMMMMMMMMMMMMTTTTT
TTTTTTMMXMMTTMMMMMTTTTTT
TTTTTTTMMM TTMMNMMTTTTT
TTTTTTTMMMMMMMMMMMMTTTT
TTTTTTTMMMMMMMMMMMMTTTT
TTTTTTXMMMMMMMMMMMMTTTT
TTTTTTMMMMMMM NMMMMTTTT
TTTTTTTMMMMMMMMMMMMTTTTT
TTTTTTTTTTMMMMMMMMTTTTTT
TTTTTTTTTTMMA MTTTTTTTTT
