TTTTTTTTTMMMMMMMMMTTTTTTTT
TTTTTTTTMMMXMMMMMMTTTTTT
TTTTTTTMMMMMMMMMMMMTTTTT
TTTTTTMMMMMMMMMMMMMTTTTT
TTTTTTMMMMTTMMMMMMMTTTTT
TTTTTMMMMMTTTMMMMMMTTTTT
TTTTTMM G MMMMMMMTTTTTTT
TTTTTTMMMMMMMMMTTTTTTTTT
TTTTTTMMMMNMMM TTTTTTTTT
TTTTTMMMMMMMMMMMMTTTTTTT
TTTTTMMMMMMMMMMMMMTTTTT
TTTTTMM X MMMMMMMTTTTTT
TTTTTTMMMMMMMMNMTTTTTTT
TTTTTTTTTMMMMMMMMMTTTTT
TTTTTTTTTTMMMMMMMMTTTTT
TTTTTTTTTTTTMMMMMMTTTTT
TTTTTTTTTTTTMMNMMMTTTTT
TTTTTTTTTTTMMMMMMMMTTTTT
TTTTTTTTTTMMMMMMMMTTTTTT
TTTTTTTTTTMM A MTTTTTTTT
